B B B B B B B B B B B B B B B B B B B B B B B B
B B B B B B B B B B B B B B B B B B B B B B B B
B B B B B B B B B B B B B B B B B B B B B B B B
B B B B B B B B B B M B M B B P B B B B B B B B
B B B B B B P B M P B P B P B P B M B B B B B B
B B B B B B B B B B B B B B B B B B B B B B B B
B B B B B B P B M B B B B B B B P M B B B B B B
B B B B B B B B B B B P B P B B B B B B B B B B
B B B B B B B P M B B B J B B B P M B B B B B B
B B B B B B B B B B B P B P B B B B B B B B B B
B B B B B B B P M B B B B B P B P B B B B B B B
B B B B B B B B B B M B P B B B B M B B B B B B
B B B B M P B P B B B B B B P B B B B B B B B B
B B B B B B B B B B B B B B B B B B B B B B B B
B B B B B B P B M B P B M B B P P M B B B B B B
B B B B B B B B B B B B B B B B B B B B B B B B