B B B B B B B B B B B B B B B B B B B B B B B B
B B B P P B B B B B B B B B B B B B B B B B B B
B B B B B B B B B B B B B B B M B B M B B B B B
B B B B B B M P B P B B P B B P P B B B B B B B
B B B M B B B P B B B B B B B B P B M B B B B B
B B B B B B B B B M P M M B B B B B B B B B B B
B B B B B B B B B P M B P P B B P B B B B B B B
B B B B B B B B B P P B P M P P B B B M B B B B
B B B B B B B P B P M B M P P M P B B B B B B B
B B B M B B B P B B P B B P P P B B B B B B B B
B B B B B B B B P B B B B B B B B B B B B B B B
B B M B B B B B B P P B B B P B B B B M B B B B
B B B P B B B B B B B B P B B B B B B B B B B B
B B B P B B B B B B P B P B B B B B B M B B B B
B B B B B B B B B B P B P B B B B B B B B B B B
B B B B B B B B B M P J P M B B B B B B B B B B