B B B B B B B B B B B B B B B B B B B B B B B B
B B B B B M B B B B B B B B B B B P P P P B B B
B B B B B B B B B B B B B B M B B P B B B B B B
B B B B B B B B B B B B B B B B P B B B B B B B
B B B B B B B M B B B B B B P P B B B B B B B B
B B B B B B B B B B B P P P P B B B B B B B B B
B B B B B B B B B B B B B B B B B B M B B B B B
B B B B B B B B B B B B B B B M B B B B B B B B
B B B B B B B B B B B B B B B B B B B B B B B B
B B B B B B B J B B B P B B B B B B B B B B B B
B B B M B B B B B B B P B B B B B B B B B B B B
B B B B B B B B B B B P B B B B B B B B B B B B
P P P P P P P P P P P P B B B B B B B B B B B B
B B B B B B B B B B B B B B B B B B B B B B B B
B B B B B B B B B B B B B B M B B B B B B B B B
B B B B B B B B B B B B B B B B B B B B B B B B