B B B B B B B B B B B B B P B P M B M B M B M B
B B B P P B B B B P B B B B B P B M B M B M B M
B B B B B B B B B P B B B B B B B B B B B B B B
B B B P M B B B B B B B B P B P P B B B P P P P
B B B B B B B B B P B B B B B B B M B B M B B B
B B B B P B B B B B B B B P B B B B B B B B B B
B B B P M B B B B P B B B B B B P B B B P P M P
B B B B B B B B B B B B B B B B B B B B B B B B
B B B B B B B B B P P B B B B B B B B B B B B B
B B B P M P B B B B P P P B P P B P B P B B B B
B B B P B B B B B B B P B B B B B B B B B B B B
B B B B B P B B B B B P B B B B B B B B B B B B
B B B P M B B B B B B P B B B B B B B B B B B B
B B B P B P B B B B B P B B B B B B B B B B B B
B B B B B B B B B B P P B M B B M B M B B B B B
B B B B B B B B B B P J B B B B B B B B B B B B